version https://git-lfs.github.com/spec/v1
oid sha256:b121e6366f059e0a64a75a09e1968bd217af0b3410528fc177a29ee35e357834
size 1874
